####################
##.##     ##########
##           .######
#   ####   #####  ##
#   ##### # ##     #
#   ###            #
#     #    #  ######
##  ###### #    ####
##  #  ### #  ######
##           #######
#####  #############
####   ####..#..####
#####            ###
###########  #   ###
####################
5 2
7 12
2 8
8 8
9 9
13 7
16 10


