#################
##.##     #######
##           .###
#   ####   ######
#   ##### # #####
#   ###      ####
#     #    ######
##  ###### ######
##  ###### ######
##       ..######
#################
#################
5 2
7 9
2 5
8 5
9 6

